{
  "map01": [
    ["v", "v", "p", "r", "r", "p", "v", "v"],
    ["v", "v", "p", "r", "r", "p", "v", "v"],
    ["v", "v", "p", "r", "r", "p", "v", "v"],
    ["v", "v", "p", "r", "r", "p", "v", "v"],
    ["v", "v", "p", "r", "r", "p", "v", "v"],
    ["v", "v", "p", "r", "r", "p", "v", "v"],
    ["v", "v", "p", "r", "r", "p", "v", "v"],
    ["v", "v", "p", "r", "r", "p", "v", "v"],
    ["v", "v", "p", "r", "r", "p", "v", "v"],
    ["v", "v", "p", "r", "r", "p", "v", "v"],
    ["v", "v", "p", "r", "r", "p", "v", "v"],
    ["v", "v", "p", "r", "r", "p", "v", "v"]
  ],

  "map02": [
    ["p", "p", "p", "r", "r", "r", "r", "r", "r", "p", "p", "p"],
    ["p", "p", "p", "r", "r", "r", "r", "r", "r", "p", "p", "p"],
    ["p", "p", "p", "r", "r", "r", "r", "r", "r", "p", "p", "p"],
    ["p", "p", "p", "r", "r", "r", "r", "r", "r", "p", "p", "p"],
    ["p", "p", "p", "r", "r", "r", "r", "r", "r", "r", "r", "r"],
    ["p", "p", "p", "r", "r", "r", "r", "r", "r", "r", "r", "r"],
    ["p", "p", "p", "r", "r", "r", "r", "r", "r", "r", "r", "r"],
    ["p", "p", "p", "r", "r", "r", "r", "r", "r", "r", "r", "r"],
    ["p", "p", "p", "r", "r", "r", "r", "r", "r", "p", "p", "p"],
    ["p", "p", "p", "r", "r", "r", "r", "r", "r", "p", "p", "p"],
    ["p", "p", "p", "r", "r", "r", "r", "r", "r", "p", "p", "p"],
    ["p", "p", "p", "r", "r", "r", "r", "r", "r", "p", "p", "p"]
  ],
  "map03": [
    ["p", "p", "p", "r", "r", "r", "r", "r", "r", "p", "p", "p"],
    ["p", "p", "p", "r", "r", "r", "r", "r", "r", "p", "p", "p"],
    ["p", "p", "p", "r", "r", "r", "r", "r", "r", "p", "p", "p"],
    ["r", "r", "r", "r", "r", "r", "r", "r", "r", "r", "r", "r"],
    ["r", "r", "r", "r", "r", "r", "r", "r", "r", "r", "r", "r"],
    ["r", "r", "r", "r", "r", "r", "r", "r", "r", "r", "r", "r"],
    ["r", "r", "r", "r", "r", "r", "r", "r", "r", "r", "r", "r"],
    ["r", "r", "r", "r", "r", "r", "r", "r", "r", "r", "r", "r"],
    ["r", "r", "r", "r", "r", "r", "r", "r", "r", "r", "r", "r"],
    ["p", "p", "p", "r", "r", "r", "r", "r", "r", "p", "p", "p"],
    ["p", "p", "p", "r", "r", "r", "r", "r", "r", "p", "p", "p"],
    ["p", "p", "p", "r", "r", "r", "r", "r", "r", "p", "p", "p"]
  ],
  "map04": [
    ["p", "p", "p", "p", "p", "p", "p", "p", "p", "p", "p", "p"],
    ["p", "p", "p", "p", "p", "p", "p", "p", "p", "p", "p", "p"],
    ["r", "r", "r", "r", "r", "r", "r", "r", "r", "r", "r", "r"],
    ["r", "r", "r", "r", "r", "r", "r", "r", "r", "r", "r", "r"],
    ["r", "r", "r", "r", "r", "r", "r", "r", "r", "r", "r", "r"],
    ["p", "p", "p", "r", "r", "r", "r", "r", "r", "p", "p", "p"],
    ["p", "p", "p", "r", "r", "r", "r", "r", "r", "p", "p", "p"],
    ["p", "p", "p", "r", "r", "r", "r", "r", "r", "p", "p", "p"],
    ["p", "p", "p", "r", "r", "r", "r", "r", "r", "p", "p", "p"],
    ["p", "p", "p", "r", "r", "r", "r", "r", "r", "p", "p", "p"],
    ["p", "p", "p", "r", "r", "r", "r", "r", "r", "p", "p", "p"],
    ["p", "p", "p", "r", "r", "r", "r", "r", "r", "p", "p", "p"]
  ]
}
