{
  "map01": [
    ["v", "v", "p", "r", "r", "p", "v", "v"],
    ["v", "v", "p", "r", "r", "p", "v", "v"],
    ["v", "v", "p", "r", "r", "p", "v", "v"],
    ["v", "v", "p", "r", "r", "p", "v", "v"],
    ["v", "v", "p", "r", "r", "p", "v", "v"],
    ["v", "v", "p", "r", "r", "p", "v", "v"],
    ["v", "v", "p", "r", "r", "p", "v", "v"],
    ["v", "v", "p", "r", "r", "p", "v", "v"],
    ["v", "v", "p", "r", "r", "p", "v", "v"],
    ["v", "v", "p", "r", "r", "p", "v", "v"],
    ["v", "v", "p", "r", "r", "p", "v", "v"],
    ["v", "v", "p", "r", "r", "p", "v", "v"]
  ],
  "map02": [
    ["v", "v", "p", "r", "r", "p", "v", "v"],
    ["v", "v", "p", "r", "r", "p", "v", "v"],
    ["v", "v", "p", "r", "r", "p", "v", "v"],
    ["v", "v", "p", "r", "r", "p", "p", "p"],
    ["v", "v", "p", "r", "r", "r", "r", "r"],
    ["v", "v", "p", "r", "r", "r", "r", "r"],
    ["v", "v", "p", "r", "r", "r", "r", "r"],
    ["v", "v", "p", "r", "r", "r", "r", "r"],
    ["v", "v", "p", "r", "r", "p", "p", "p"],
    ["v", "v", "p", "r", "r", "p", "v", "v"],
    ["v", "v", "p", "r", "r", "p", "v", "v"],
    ["v", "v", "p", "r", "r", "p", "v", "v"]
  ],
  "map03": [
    ["v", "v", "p", "r", "r", "p", "v", "v"],
    ["v", "v", "p", "r", "r", "p", "v", "v"],
    ["v", "v", "p", "r", "r", "p", "v", "v"],
    ["p", "p", "p", "r", "r", "p", "p", "p"],
    ["r", "r", "r", "r", "r", "r", "r", "r"],
    ["r", "r", "r", "r", "r", "r", "r", "r"],
    ["r", "r", "r", "r", "r", "r", "r", "r"],
    ["p", "p", "p", "r", "r", "p", "p", "p"],
    ["v", "v", "p", "r", "r", "p", "v", "v"],
    ["v", "v", "p", "r", "r", "p", "v", "v"],
    ["v", "v", "p", "r", "r", "p", "v", "v"],
    ["v", "v", "p", "r", "r", "p", "v", "v"]
  ],
  "map04": [
    ["v", "v", "v", "v", "v", "v", "v", "v"],
    ["p", "p", "p", "p", "p", "p", "p", "p"],
    ["r", "r", "r", "r", "r", "r", "r", "r"],
    ["r", "r", "r", "r", "r", "r", "r", "r"],
    ["p", "p", "p", "r", "r", "p", "p", "p"],
    ["v", "v", "p", "r", "r", "p", "v", "v"],
    ["v", "v", "p", "r", "r", "p", "v", "v"],
    ["v", "v", "p", "r", "r", "p", "v", "v"],
    ["v", "v", "p", "r", "r", "p", "v", "v"],
    ["v", "v", "p", "r", "r", "p", "v", "v"],
    ["v", "v", "p", "r", "r", "p", "v", "v"],
    ["v", "v", "p", "r", "r", "p", "v", "v"]
  ]
}
